Tajna Novog Vinodolskog
An Interactive Fiction by Marta
Release 1 / Serial number 220115 / Inform 7 build 6M62 (I6/v6.33 lib 6/12N) SD

Konoba
You are surrounded by shelves with various drinks. In front of you you see a table with an old diary. The door to the north leads to the path.

You can see Vrata here.

>look
Konoba

* * *

Tajna Novog Vinodolskog
An Interactive Fiction by Marta
Release 1 / Serial number 220115 / Inform 7 build 6M62 (I6/v6.33 lib 6/12N) SD

Konoba
You are surrounded by shelves with various drinks. In front of you you see a table with an old diary. The door to the north leads to the path.

You can see Vrata here.

>go north
(first opening Vrata)

Puteljak
The sun is shining outside, but there is a mystical silence. You can't even hear the birds singing. South of you is the door of the tavern, if you continue to go north you will come to the city center.

You can see Vrata here.

>go north
Centar
You are in the city center. North of you is the Street, while south of you is a path that you can take back to the tavern.

Lazo is a man who owns a local cafe in Novi Vinodoslki. He's standing in front of you right now.

>go north
Ulica
You are in the street of the old town that leads to the church. If you want to get to the church go north, if you want to go downtown go south.

You can see Vrata2 here.

>go north
(first opening Vrata2)

Crkva
You are now in the church of St. Philip and St. Jacob. If you want to go to the square you have to go out the back door which is to the north, if you want to go back to the street or to the south.

The priest is here.

You can also see Vrata2 and Vrata3 here.

>go north
(first opening Vrata3)

Trg
You are in the square. If you go north you will reach the bell tower. If you want to go back to church go south.

You can see Vrata3 and Vrata4 here.

>go north
(first opening Vrata4)

Zvonik
The bell ringer is here.

You can also see Vrata4, Tajna vrata and a box (closed) here.

>take box
You picked up the box and now you have the key that opens the secret door to you.

>unlock Tajna vrata
(with Kljuc)
That doesn't seem to be something you can unlock.

* * *

>go north
(first opening Vrata4)

Zvonik
The bell ringer is here.

You can also see Vrata4, Tajna vrata and a box (closed) here.

>pick up box
You picked up the box and now you have the key that opens the secret door to you.

>unlock Tajna vrata
(with Kljuc)
You unlock Tajna vrata.

* * *

>pick up box
You picked up the box and now you have the key that opens the secret door to you.

>unlock tajna vrata
(with Kljuc)
You unlock Tajna vrata.

>go north
(first opening Tajna vrata)

Katakomba
Congratulations, you made it to the catacombs. In front of you is a cure for covid, you just have to pick it up.

You can see Tajna vrata and Cure here.

>pick up cure
Taken.

>look at cure
You won! Novi Vinodolski is free of covids forever!

* * *

Tajna Novog Vinodolskog
An Interactive Fiction by Marta
Release 1 / Serial number 220115 / Inform 7 build 6M62 (I6/v6.33 lib 6/12N) SD

Konoba
You are surrounded by shelves with various drinks. In front of you you see a table with an old diary. The door to the north leads to the path.

You can see Vrata here.

>n
Puteljak
Vani sija sunce, ali vlada neka mistična tišina. Čak se ne čuje ni pjev ptica. Južno od tebe nalazi se konoba.

>s
Konoba
Okružen si policama na kojima stoje razna pića. Ispred sebe vidiš stol na kojem se nalazi stari dnevnik. Vrata koja se nalaze sjeverno vode do puteljka.

* * *

>n
Puteljak
Vani sija sunce, ali vlada neka mistična tišina. Čak se ne čuje ni pjev ptica. Južno od tebe nalazi se konoba.

>n
Centar

>n
Ulica

>n
Crkva

>n
Trg

>n
Zvonik

>n
Tajna vrata

>n
Katakomba

I beg your pardon?

>s
Tajna vrata

>s
Zvonik

>s
Trg

>s
Crkva

>s
Ulica

>s
Centar

>s
Puteljak
Vani sija sunce, ali vlada neka mistična tišina. Čak se ne čuje ni pjev ptica. Južno od tebe nalazi se konoba.

>s
Konoba
Okružen si policama na kojima stoje razna pića. Ispred sebe vidiš stol na kojem se nalazi stari dnevnik. Vrata koja se nalaze sjeverno vode do puteljka.

>look at dnevnik
You can't see any such thing.

* * *

Tajna Novog Vinodolskog
An Interactive Fiction by Marta
Release 1 / Serial number 220115 / Inform 7 build 6M62 (I6/v6.33 lib 6/12N) SD

Konoba
You are surrounded by shelves with various drinks. In front of you you see a table with an old diary. The door to the north leads to the path.

You can see Vrata here.

>look at drinks
You see nothing special about the drinks.

>look at drinks
You see nothing special about the drinks.

* * *

Tajna Novog Vinodolskog
An Interactive Fiction by Marta
Release 1 / Serial number 220115 / Inform 7 build 6M62 (I6/v6.33 lib 6/12N) SD

Konoba
You are surrounded by shelves with various drinks. In front of you you see a table with an old diary. The door to the north leads to the path.

You can see Vrata here.

>look at shelves
There are various dust-covered bottles on the shelf. One bottle differs from the others by its colorful design.

>look at drinks
You see nothing special about the drinks.

* * *

>look at shelves
There are various dust-covered bottles on the shelf. One bottle differs from the others by its colorful design.

>take shelves
You can't take the shelves with you, they're built-in.

* * *

>look at shelves
There are various dust-covered bottles on the shelf. One bottle differs from the others by its colorful design.

>look at bottle
You see the bottle and realize that there is something in it.

>take bottle
That's hardly portable.

* * *

>look at bottle
You see the bottle and realize that there is something in it.

>open bottle
You open the bottle, revealing a paper.

>look at paper
In the catacomb lies the secret to getting out of this situation, Lazo who is in the Center will tell you how to get to the catacomb.

>take paper
Taken.

>open vrata
You open Vrata.

>go north
Puteljak
The sun is shining outside, but there is a mystical silence. You can't even hear the birds singing. South of you is the door of the tavern, if you continue to go north you will come to the city center.

You can see Vrata here.

>go north
Centar
You are in the city center. North of you is the Street, while south of you is a path that you can take back to the tavern.

Lazo is a man who owns a local cafe in Novi Vinodoslki. He's standing in front of you right now.

>look lazo
Lazo is a man of medium height and dubious past. He has brown eyes and short brown hair. He is dressed as a bum.

>ask lazo about catacomb
Lazo says: "Catacombs? No one has asked me that for years. You have to go north down the street and get to the church. At the church, look for a priest to guide you."

>go north
Ulica
You are in the street of the old town that leads to the church. If you want to get to the church go north, if you want to go downtown go south.

You can see Vrata2 here.

>open Vrata2
You open Vrata2.

>go north
Crkva
You are now in the church of St. Philip and St. Jacob. If you want to go to the square you have to go out the back door which is to the north, if you want to go back to the street or to the south.

The priest is here.

You can also see Vrata2 and Vrata3 here.

>look priest
The priest is a tall man with dark hair and blue eyes. He is dressed in his priestly uniform.

>ask priest about catacomb
Priest says: "Who told you about the catacombs?."

>tell priest about that
You say: "I heard about the catacombs from a piece of paper I found in a tavern in a bottle."

>ask priest about more
Priest says: "Are you sure you want to know more? If I tell you the truth, there is no going back."

>tell priest yes
I didn't understand that sentence.

>tell priest about sure
You say: "I am ready to deal with the truth."

>ask priest abot truth
I didn't understand that sentence.

>ask priest about truth
Priest says: "Okay. There is a cure for covid 19 in the catacombs. Now you must feel obliged to find it. You will learn more about this from the old bell ringer. Please give me the paper you found so I can put it back in place."

>drop paper
Dropped.

>unlock vrata3
What do you want to unlock Vrata3 with?

>open vrata3
You open Vrata3.

>nventory
That's not a verb I recognise.

>inventory
You are carrying nothing.

>go north
Trg
You are in the square. If you go north you will reach the bell tower. If you want to go back to church go south.

You can see Vrata3 and Vrata4 here.

>open vrata4
You open Vrata4.

>go north
Zvonik
The bell ringer is here.

You can also see Vrata4, Tajna vrata and a box (closed) here.

>look at bell ringer
The bell ringer is an older man with a hunched back. He looks sullen and depressed. He has a larger physique.

>ask bell ringer about catacomb
Bell ringer says: "To enter the catacombs you must find the key that opens the secret door."

>ask bell ringer about key
Bell ringer says: "You have to answer this riddle for me. What is always in front of you but can't be seen?"

>tell bell ringer about future
This provokes no reaction.

>tell bell ringer about answer
This provokes no reaction.

>ask bell ringer about right answer
Bell ringer says: "No one has given me the correct answer to this riddle so far. The key is in the little box, you just have to pick it up."

>pick up box
You picked up the box and now you have the key that opens the secret door to you.

* * *

>unlock tajna vrata
(with Kljuc)
You unlock Tajna vrata.

>go north
(first opening Tajna vrata)

Katakomba
Congratulations, you made it to the catacombs. In front of you is a cure for covid, you just have to pick it up.

You can see Tajna vrata here.

>pick up lijek
You can't see any such thing.

>pick up Lijek
You can't see any such thing.

>take Lijek
You can't see any such thing.

* * *

>look at shelves
There are various dust-covered bottles on the shelf. One bottle differs from the others by its colorful design.

>look at the bottle
You see the bottle and realize that there is something in it.

>open the bottle
You open the bottle, revealing a paper.

* * *

Tajna Novog Vinodolskog
An Interactive Fiction by Marta
Release 1 / Serial number 220115 / Inform 7 build 6M62 (I6/v6.33 lib 6/12N) SD

Konoba
You are surrounded by shelves with various drinks. In front of you you see a table with an old diary. The door to the north leads to the path.

You can see Vrata here.

>take the old diary
Taken.

>take the diary
You already have that.

>inventory
You are carrying:
  an old diary

>centar
That's not a verb I recognise.

>n
Puteljak
Vani sija sunce, ali vlada neka mistična tišina. Čak se ne čuje ni pjev ptica. Južno od tebe nalazi se konoba.

>drop diary
Dropped.

>inv
You are carrying nothing.

>take diary
Taken.

>drop diary
Dropped.

>look
Puteljak
Vani sija sunce, ali vlada neka mistična tišina. Čak se ne čuje ni pjev ptica. Južno od tebe nalazi se konoba. 

You can see an old diary here.

>take diary
Taken.

>s
Konoba
You are surrounded by shelves with various drinks. In front of you you see a table with an old diary. The door to the north leads to the path.

You see the shelves here.

You see the drinks here.

>drop diary
Dropped.

* * *

Tajna Novog Vinodolskog
An Interactive Fiction by Marta
Release 1 / Serial number 220115 / Inform 7 build 6M62 (I6/v6.33 lib 6/12N) SD

Konoba
You are surrounded by shelves with various drinks. In front of you you see a table with an old diary. The door to the north leads to the path.

You can see Vrata here.

>look at diary
You can see something written in this diary.

* * *

Tajna Novog Vinodolskog
An Interactive Fiction by Marta
Release 1 / Serial number 220115 / Inform 7 build 6M62 (I6/v6.33 lib 6/12N) SD

Konoba
You are surrounded by shelves with various drinks. In front of you you see a table with an old diary. The door to the north leads to the path.

You can see Vrata here.

>take diary
You'll get sick.

>take old diary
That's hardly portable.

>look at diary
Looking at this old diary in your hands, you realize that it was written by the natives of Novi Vinodolski during the pandemic. They described how they spent each day attaching photos. You realize one page of the diary is missing.

* * *

Tajna Novog Vinodolskog
An Interactive Fiction by Marta
Release 1 / Serial number 220115 / Inform 7 build 6M62 (I6/v6.33 lib 6/12N) SD

Konoba
You are surrounded by shelves with various drinks. In front of you you see a table with an old diary. The door to the north leads to the path.

You can see Vrata here.

>look at the table
You look at the wooden table where the old diary is.

>take table
The table is too heavy to take.

>look at the diary
Looking at this old diary in your hands, you realize that it was written by the natives of Novi Vinodolski during the pandemic. They described how they spent each day attaching photos. You realize one page of the diary is missing.

* * *

>look at the table
You look at the wooden table where the old diary is.

>look at the diary
Looking at this old diary in your hands, you realize that it was written by the natives of Novi Vinodolski during the pandemic. They described how they spent each day attaching photos. You realize one page of the diary is missing.

>take diary
The diary must stay here.

>take table
The table is too heavy to take.

>look at the shelves
There are various dust-covered bottles on the shelf. One bottle differs from the others by its colorful design.

>take shelves
You can't take the shelves with you, they're built-in.

>look at the bottle
You see the bottle and realize that there is something in it.

>open bottle
You open the bottle, revealing a paper.

>look at the paper
In the catacomb lies the secret to getting out of this situation, Lazo who is in the Center will tell you how to get to the catacomb.

>take paper
Taken.

>inventory
You are carrying:
  a paper

>open vrata
You open Vrata.

* * *

>go north
Centar
You are in the city center. North of you is the Street, while south of you is a path that you can take back to the tavern.

Lazo is a man who owns a local cafe in Novi Vinodoslki. He's standing in front of you right now.

>look at lazo
Lazo is a man of medium height and dubious past. He has brown eyes and short brown hair. He is dressed as a bum.

>ask lazo about catacombs
Lazo says: "Catacombs? No one has asked me that for years. Everyone is afraid of physical contact with other people in order not to get infected. You have to go north down the street and get to the church. At the church, look for a priest to guide you."

>go north
Ulica
You are in the street of the old town that leads to the church. If you want to get to the church go north, if you want to go downtown go south.

You can see Vrata2 here.

>open vrata2
You open Vrata2.

>go north
Crkva
You are now in the church of St. Philip and St. Jacob. If you want to go to the square you have to go out the back door which is to the north, if you want to go back to the street or to the south.

The priest is here.

You can also see Vrata2 and Vrata3 here.

>look at priest
The priest is a tall man with dark hair and blue eyes. He is dressed in his priestly uniform.

>ask priest about catacomb
Priest says: "Who told you about the catacombs?."

>tell rpiest about that
You can't see any such thing.

>tell priest about that
You say: "I heard about the catacombs from a piece of paper I found in a tavern in a bottle."

* * *

>ask priest about more
Priest says: "Are you sure you want to know more? If I tell you the truth, there is no going back."

>tell priest about yes
You say: "I am ready to deal with the truth."

>ask priest about truth
Priest says: "Okay. There is a cure for covid 19 in the catacombs. Now you must feel obliged to find it. You will learn more about this from the old bell ringer. Please give me the paper you found so I can put it back in place."

>tell priest about understood
You say: "I understood, thanks for the information. I will do my best."

>look at vrata3
Small wooden church back door.

>open vrata3
You open Vrata3.

>go north
Trg
You are in the square. If you go north you will reach the bell tower. If you want to go back to church go south.

You can see Vrata3 and Vrata4 here.

>look vrata4
Ordinary bell tower door.

>open vrata4
You open Vrata4.

>go north
Zvonik
The bell ringer is here.

You can also see Vrata4 and Tajna vrata here.

>look at tajna vrata
You came to the secret door. If you want to continue to the catacombs go north, if you want to return to the bell tower go south.

>go north
(first opening Tajna vrata)
It seems to be locked.

>unlock tajna vrata
(with the paper)
That doesn't seem to fit the lock.

>look at bell ringer
The bell ringer is an older man with a hunched back. He looks sullen and depressed. He has a larger physique.

>ask bell ringer about catacombs
Bell ringer says: "To enter the catacombs you must find the key that opens the secret door."

* * *

>look at the table
You look at the wooden table where the old diary is.

>look at the old diary
Looking at this old diary in your hands, you realize that it was written by the natives of Novi Vinodolski during the pandemic. They described how they spent each day attaching photos. You realize one page of the diary is missing.

>take diary
The diary must stay here.

* * *

>take table
The table is too heavy to take.

>look at shelves
There are various dust-covered bottles on the shelf. One bottle differs from the others by its colorful design.

* * *

>open bottle
You open the bottle, revealing a paper.

>take bottle
The bottle must stay in the tavern! You can't take it with you..

>look at the paper
In the catacomb lies the secret to getting out of this situation, Lazo who is in the Center will tell you how to get to the catacomb.

* * *

>inventory
You are carrying:
  a paper

>tabke shelves
That's not a verb I recognise.

>take shelves
You can't take the shelves with you, they're built-in.

>look at vrata
A small old wooden tavern door.

>go north
(first opening Vrata)

Puteljak
The sun is shining outside, but there is a mystical silence. You can't even hear the birds singing. South of you is the door of the tavern, if you continue to go north you will come to the city center.

You can see Vrata here.

* * *

>go north
Ulica
You are in the street of the old town that leads to the church. If you want to get to the church go north, if you want to go downtown go south.

You can see Vrata2 here.

>look at vrata2
Large wooden church door.

>go north
(first opening Vrata2)

Crkva
You are now in the church of St. Philip and St. Jacob. If you want to go to the square you have to go out the back door which is to the north, if you want to go back to the street or to the south.

The priest is here.

You can also see Vrata2 and Vrata3 here.

>look at priest
The priest is a tall man with dark hair and blue eyes. He is dressed in his priestly uniform.

>ask priest about catacombs
Priest says: "Who told you about the catacombs?."

>tell priest about that
You say: "I heard about the catacombs from a piece of paper I found in a tavern in a bottle."

* * *

>look at vrata3
Small wooden church back door.

>go north
(first opening Vrata3)

Trg
You are in the square. If you go north you will reach the bell tower. If you want to go back to church go south.

You can see Vrata3 and Vrata4 here.

>look at vrata4
Ordinary bell tower door.

>open vrata4
You open Vrata4.

* * *

>look at tajna vrata
You came to the secret door. If you want to continue to the catacombs go north, if you want to return to the bell tower go south.

>open tajna vrata
It seems to be locked.

>unlock tajna vrata
(with the paper)
That doesn't seem to fit the lock.

* * *

>ask bell ringer about key
Bell ringer says: "You have to answer this riddle for me. What is always in front of you but can't be seen?"

>tell bell ringer about baby
This provokes no reaction.

>tell bell ringer about idk
This provokes no reaction.

>tell bell ringer about answer
You say: "The future."

>ask bell ringer about right answe
There is no reply.

>ask bell ringer about right answer
Bell ringer says: "No one has given me the correct answer to this riddle so far. The key is in the little box, you just have to pick it up."

>tell bell riher about ok
I didn't understand that sentence.

>tell bell ringer about ok
You say: "I am honored to be the first person to solve this puzzle. Thank you!"

>look at box
You see a box with something in it..

>pick up box
You picked up the box and now you have the key that opens the secret door to you.

>ulock tajna vrata
That's not a verb I recognise.

>unlock tajna vrata
What do you want to unlock Tajna vrata with?

>inventory
You are carrying:
  Kljuc
  a paper

>unlock tajna vrata
What do you want to unlock Tajna vrata with?

>open tajna vrata
It seems to be locked.

>Unlock tajna vrata
What do you want to unlock Tajna vrata with?

>Unlock Tajna vrata
What do you want to unlock Tajna vrata with?

>take kljuc
You already have that.

>unlock tajna vrata
What do you want to unlock Tajna vrata with?

>drop paper
Dropped.

>unlock tajna vrata
(with Kljuc)
You unlock Tajna vrata.

* * *

Tajna Novog Vinodolskog
An Interactive Fiction by Marta
Release 1 / Serial number 220115 / Inform 7 build 6M62 (I6/v6.33 lib 6/12N) SD

Konoba
You are surrounded by shelves with various drinks. In front of you you see a table with an old diary. The door to the north leads to the path.

You can see Vrata here.

>look at paper
The paper is crumpled in the shape of a lump.

>open paper
It isn't something you can open.

* * *

Tajna Novog Vinodolskog
An Interactive Fiction by Marta
Release 1 / Serial number 220115 / Inform 7 build 6M62 (I6/v6.33 lib 6/12N) SD

Konoba
You are surrounded by shelves with various drinks. In front of you you see a table with an old diary. The door to the north leads to the path.

You can see Vrata here.

I beg your pardon?

* * *

Tajna Novog Vinodolskog
An Interactive Fiction by Marta
Release 1 / Serial number 220115 / Inform 7 build 6M62 (I6/v6.33 lib 6/12N) SD

Konoba
You are surrounded by shelves with various drinks. In front of you you see a table with an old diary. The door to the north leads to the path.

You can see Vrata here.

>look at bottle
You see the bottle and realize that there is something in it.

>take paper
You can't see any such thing.

>put paper in bottle
You put the paper into the bottle.

>look
Konoba
You are surrounded by shelves with various drinks. In front of you you see a table with an old diary. The door to the north leads to the path.

You can see a bottle (in which is a paper) here.

* * *

>open bottle
You open the bottle, revealing a paper.

>take paper
Taken.

>drop paper
Dropped.

>open bottle
That's already open.

>look at bottle
You see the bottle and realize that there is a piece of paper in it.

>take paper
Taken.

>drop paper in bottle
You put the paper into the bottle.

* * *

>take paper
Taken.

>look at paper
In the catacomb lies the secret to getting out of this situation, Lazo who is in the center will tell you how to get to the catacomb.

>put paper on table.
Putting things on the table would achieve nothing.

>put bottle on table
(first taking the bottle)
Putting things on the table would achieve nothing.

* * *

Tajna Novog Vinodolskog
An Interactive Fiction by Marta
Release 1 / Serial number 220115 / Inform 7 build 6M62 (I6/v6.33 lib 6/12N) SD

Konoba
You are surrounded by shelves with various drinks. In front of you you see a table with an old diary. The door to the north leads to the path.

You can see Vrata here.

>take bottle
Taken.

>put bottle on table
You put the bottle on the table.

>look at table
You look at the wooden table where the old diary is.

On the table is a bottle (closed).

* * *

Tajna Novog Vinodolskog
An Interactive Fiction by Marta
Release 1 / Serial number 220115 / Inform 7 build 6M62 (I6/v6.33 lib 6/12N) SD

Konoba
You are surrounded by shelves with various drinks. In front of you you see a table with an old diary. The door to the north leads to the path.

You can see Vrata here.

>look at the dor
You can't see any such thing.

>look at the Vrata
A small old wooden tavern door.

>unlock Vrata
What do you want to unlock Vrata with?

* * *

Tajna Novog Vinodolskog
An Interactive Fiction by Marta
Release 1 / Serial number 220115 / Inform 7 build 6M62 (I6/v6.33 lib 6/12N) SD

Konoba
You are surrounded by shelves with various drinks. In front of you you see a table with an old diary. The door to the north leads to the path.

You can see Vrata here.

>look at vrata
A small old wooden tavern door.

>open vrata
You open Vrata.

>go north
Puteljak
Vani sija sunce, ali vlada neka mistična tišina. Čak se ne čuje ni pjev ptica. Južno od tebe nalazi se konoba. 

You can see Vrata here.

* * *

Tajna Novog Vinodolskog
An Interactive Fiction by Marta
Release 1 / Serial number 220115 / Inform 7 build 6M62 (I6/v6.33 lib 6/12N) SD

Konoba
You are surrounded by shelves with various drinks. In front of you you see a table with an old diary. The door to the north leads to the path.

You can see Vrata here.

>open Vrata
You open Vrata.

>go north
Puteljak
The sun is shining outside, but there is a mystical silence. You can't even hear the birds singing. South of you is the door of the tavern, if you continue to go north you will come to the city center.

You can see Vrata here.

* * *

>go north
Centar
You are in the city center. North of you is the Street, while south of you is a path that you can take back to the tavern.

Lazo is a man who owns a local cafe in Novi Vinodoslki. He's standing in front of you right now.

>look Lazo
Lazo is a man of medium height and dubious past. He has brown eyes and short brown hair. He is dressed as a bum.

>where is catacomb
That's not a verb I recognise.

>ask Lazo about catacomb
Lazo says: Why are you interested in that?."

* * *

Tajna Novog Vinodolskog
An Interactive Fiction by Marta
Release 1 / Serial number 220115 / Inform 7 build 6M62 (I6/v6.33 lib 6/12N) SD

Konoba
You are surrounded by shelves with various drinks. In front of you you see a table with an old diary. The door to the north leads to the path.

You can see Vrata here.

>opet Vrata
That's not a verb I recognise.

>open Vrata
You open Vrata.

* * *

>look lazo
Lazo is a man of medium height and dubious past. He has brown eyes and short brown hair. He is dressed as a bum.

>whre are catacombs
That's not a verb I recognise.

>what abut catacombs
That's not a verb I recognise.

>ask Lazo about catacombs
Lazo says: "Catacombs? No one has asked me that for years. You have to go north down the street and get to the church. At the church, look for a priest to guide you."

>go north
Ulica

* * *

Tajna Novog Vinodolskog
An Interactive Fiction by Marta
Release 1 / Serial number 220115 / Inform 7 build 6M62 (I6/v6.33 lib 6/12N) SD

Konoba
You are surrounded by shelves with various drinks. In front of you you see a table with an old diary. The door to the north leads to the path.

You can see Vrata here.

>go south
You can't go that way.

>go north
(first opening Vrata)

Puteljak
The sun is shining outside, but there is a mystical silence. You can't even hear the birds singing. South of you is the door of the tavern, if you continue to go north you will come to the city center.

You can see Vrata here.

* * *

>go north
Ulica
You are in the street of the old town that leads to the church. If you want to get to the church go north, if you want to go downtown go south.

You can see Vrata2 here.

>go north
(first opening Vrata2)

Crkva
You are now in the church of St. Philip and St. Jacob. If you want to go to the square you have to go out the back door which is to the north, if you want to go back to the street or to the south.

The priest is here.

You can also see Vrata2 here.

>look at priest
The priest is a tall man with dark hair and blue eyes. He is dressed in his priestly uniform.

* * *

>ask priest about catacomb
Priest says: "Who told you about the catacombs?."

>tell priest about that
"I heard about the catacombs from a piece of paper I found in a tavern in a bottle."

* * *

Tajna Novog Vinodolskog
An Interactive Fiction by Marta
Release 1 / Serial number 220115 / Inform 7 build 6M62 (I6/v6.33 lib 6/12N) SD

Konoba
You are surrounded by shelves with various drinks. In front of you you see a table with an old diary. The door to the north leads to the path.

You can see Vrata here.

>look at the bottle
You see the bottle and realize that there is something in it.

* * *

>take paper
Taken.

>look paper
In the catacomb lies the secret to getting out of this situation, Lazo who is in the Center will tell you how to get to the catacomb.

>look at shelves
There are various dust-covered bottles on the shelf. One bottle differs from the others by its colorful design.

* * *

Tajna Novog Vinodolskog
An Interactive Fiction by Marta
Release 1 / Serial number 220115 / Inform 7 build 6M62 (I6/v6.33 lib 6/12N) SD

Konoba
You are surrounded by shelves with various drinks. In front of you you see a table with an old diary. The door to the north leads to the path.

You can see Vrata here.

>look at table
You look at the wooden table where the old diary is.

>look at diary
Looking at this old diary in your hands, you realize that it was written by the natives of Novi Vinodolski during the pandemic. They described how they spent each day attaching photos. You realize one page of the diary is missing.

>look at shelves
There are various dust-covered bottles on the shelf. One bottle differs from the others by its colorful design.

>look at bottle
You can't see any such thing.

* * *

>look at table
You look at the wooden table where the old diary is.

>look at old diary
Looking at this old diary in your hands, you realize that it was written by the natives of Novi Vinodolski during the pandemic. They described how they spent each day attaching photos. You realize one page of the diary is missing.

>look at shelves
There are various dust-covered bottles on the shelf. One bottle differs from the others by its colorful design.